10.ox
.ooo..o.....o.o...o.
...oo.oo...oo....o.o
..oo.o..o....oo.o...
..o...o.........o..o
o..oo.o.o.....oo....
o.oo..o..o.ooo......
o.o...oo.ooo.o.oo..o
.oo.............oo..
oo...o......o..o.o..
...oooo.........o.o.
