9.ox
.........
...oo.o..
.ooo.o...
.....o...
......o..
..o...oo.
...o..oo.
o...o...o
.oo......
