1010X
1011010111
1101101101
1111111111
1100011101
1111110101
1011111110
1110111101
1111110101
1111111001
0111101111
